DataTemplate - взаимодействие двух обьектов, источника и приемника
Приемник создает привязку к определенному свойству источника и в случае модификации источника, приемник так же будет модицицирован
<ListBox>
    <ListBox.ItemTemplate>
        <DataTemplate>
            <TextBox >
                        
            </TextBox>
        </DataTemplate>
    </ListBox.ItemTemplate>
</ListBox>

Основные свойства класса Binding:
1. ElementName - имя элемента к которому создается привязка
2. Mode - режим привязки. Может принимать значения:
-ОneWay - Свойство приемника изменяется после модификации свойства источника
-OneTime - свойство приемника устанавливается только один раз
-TwoWay - иемник и источник могут изменять привязанные свойства
-Path - ссылка на свойство обьекта к которому идет привязка
-Source - указывает на источник если он не является элементом управления или данные не передается из кода

События позволяют отлавливать некоторые взаимодействия с элементом управления и выполняют указывают в теле события код

Основные свойства окна:
icon - иконка в левом верхнем углу экрана и в панели задачь
top,left - задают отступ от верзней левой границы экрана

resizeMode - задает режим изменения размера окна. Может принимать следующие значения: 
-CanMinimaize - окно можно только свернуть 
-NoResize - нельзя изменить начальные размеры
-CanResize - размеры менять можно
-CanResizeWithGrip - в правом нижнем углу окна появляется визуализация того, что у окна можно изменять размеры

Title - заголовок окна
WindowState - состояние окна. Значения:
-Maximized - раскрыто на весь экран.
-Minimized - свернуто
-Normal - стандартное состояние.

В процессе работы окно проходит ряд этапов, которые могут быть доступны через обработку событий класса Window:
-Initialized: это событие возникает при инициализации окна, когда у него устанавливаются все свойства, но до применения к нему стилей и привязки данных.
- Loaded: возникает после полной инициализации окна и применения у нему стилей и привязки данных. После генерации этого события происходит визуализация элемента, и окно отображается на экране становится видимым для пользователя.
- Closing: возникает при закрытии окна.
- Closed: возникает когда окно становится закрытым.
- Unloaded: возникает после закрытия окна при выгрузке всех связанныхх ресурсов из памяти.

DataGrid - элемент управления отображением данных, который извлекает информацию из коллекции обьектов и визуализирует ее в таблице.
Каждая строка соответствует отдельному объекту(чаще всего экземпляру класса),  а каждый столбец - свойству этого объекта(чаще все свойства класса).
Свойства DataGrid: 
-RowBackground  & AlternatingRowBackground - кисть, которая исплользуется для закрашивания фона позади каждой строки(RowBackground) и фон чередующихся строк(AlternatingRowBackground).
-ColumnHeaderHeught - высота строки, отображающей заголовки столбцов.
-ColumnWidth - установка ширины по умолчанию для каждого столбца.
-RowHeight - высота строк.
-GridLinesVisibility - указывает, какие линии доложны отображаться в сетке (Horizontal, Vertical,None, All)
-HeadersVisibility - указывает, какие заголовки должны отображаться в сетке (Column, Row, All, None)
-AutoGenerateColumns - активирует автоматическое создание столбцов, на основе переданных в ItemSource данных.
-CanUserDeleteRows - фктивирует возможность удаления строк при нажатии кнопки Delete.
-CanUserAddRows - добавляет пустую строку в конце списка, которая предназначена для добавления новых элементов.

DataGrid поддерживает следующие варианты столбцов:
- DataGridTextColumn - отображает элемент TextBlock или TextBox при редактировании.
- DataGridHyperlinkColumn - представляет гиперссылку и позволяет переходить по указанному адресу.
- DataGridCheckBoxColumn - отображает элемент CheckBox
- DataGridComboBoxColumn - отображает выпадающий список - элемент ComboBox.
- DataGridTemplateColumn - позволяет задать специфичный шаблон для отображения столбца


Шаблон ячейки - CellTemplate. Свойство предназначено для задания шаблона ячейки и может содержать в себе элемент DataTemplate
Детали строк - это возможность элемента DataGrid выводить детали какой либо строки при нажатии на нее.
Реализуется с помощью свойства RowDetailsTemplate.
Свойство RowDetailsVisibilityMode по умолчанию установлено в значение VisibleWhenSelected(детали строки появляются при нажатии на нее), 
так же есть возможность установить значение Visible(детали всех строк будут видны всегда) или Collapsed(блокирует просмотр деталей строк).



